R    1000 800
F 100,100,11
NO ./textures/wall_1.xpm
SO ./textures/wall_2.xpm
WE ./textures/wall_3.xpm
EA ./textures/wall_4.xpm
S ./textures/sprite_1.xpm
C 22,20,111


1111111111111111111111
10000000001
100000000111111111111
100000000S0000000000111111111111111111111111111
1000000000000000000000000000000000000000000001
10000000000000000000000000000000000000000000001
10000002222220000000111111111111111111111111111
1000000022222000000001
100000002222200000001
10000000222220000000011
1000000000000000000001
1000000000000000000001
1000000000000000000001
1000000000000000000001
1000000000000000000001
1111111111111111111111
