R    1000 800
F 100,100,11
NO ./textures/wall_1.xpm
SO ./textures/wall_2.xpm
WE ./textures/wall_3.xpm
EA ./textures/wall_4.xpm
S ./textures/sprite_1.xpm
C 225,20,111


1111111111111111111111
10000000001
100000000111111111111
10000000000002000000111111111111111111111111111
10000200010000000000000000000000000000000000001
100W0020010000000000000000000000000000000000001
10000000000002000000111111111111111111111111111
1000002000000000000001
10000000000000000000001
10000000000000000000011
1111111111111111111111
