R    1000 600
F 255,100 , 11
NO ./pa
SO ./path_to_the_south_texture
WE        ./path_to_the_west_textur
EA ./ath_to_the_east_texture
S ./path_to_the_sprite_textur
C 225,20,111




   01 1111111111  
  11111111
 10001001111111111111111111111
10000000000000000000000000000011             
100000N00000020000000000111111
1111000200111110110000000000011111111111111
    100000000010100000000000011000000000101
    100100000010100000000000011000000000101
    100100000010100000000000011000000000101
    100100000010100000111100000000000000101
    100100000010100000000100011000000000101
    100100000000000000111100011000000000101
    100100000000100000000000011000000000101
    111111111111111111111111111000000000101
                               111111111111