R    1200 700

EA         ./textures/eagle.xpm
NO         ./textures/wall_1.xpm
SO         ./textures/wall_2.xpm
WE          ./textures/wall_3.xpm
S              ./textures/pillar.xpm

C 0,20,40
F 0,97,60

1111111111
1200000001
1100000000111111111111
10000000001020100000111111111111111111111111111
10000000001000100000000000000000000000000000021
10000000000000000000000000000000000000000000001
10000000000000000200111111111111111101111111111
1000E00000000000000001             101
1000000002000000000011             101
10000000000000000000011111111111111101111111
10000000000000000000000022222222222222222221
10000000000000000000010022222222222222222221
10011011100000000000010022222222222222222221
10021002100000000000010022222222222222222221
10001000100000000000011111111111111111111111
1111111111111111111111
