R    1000 800
F 100,100,11
NO ./textures/wall_1.xpm
SO ./textures/wall_2.xpm
WE ./textures/wall_3.xpm
EA ./textures/wall_4.xpm
S ./textures/
C 225,20,111


1111111111111111111111
1022222221
100002N00111111111111
100000000000000000000111111111111111111111111111
10000000000000000000000000000000000000000000001
100000000000000000000000000000000000000000000001
100000000000000000001011111111111111111111111111
1000000000000000000001
10000000000000000000001
10000000000000000000011
1111111111111111111111
