R    1000 800
F 100,100,11
NO ./textures/diana.xpm
SO ./textures/diana.xpm
WE ./textures/diana.xpm
EA ./textures/diana.xpm
S ./textures/
C 225,20,111


1111111111111111111111
1000000001
100000N00111111111111
100000000000000000000111111111111111111111111111
100000000000000000000000200000000000000000000001
100000000200000000000000000000000000000000000001
100000000000000000001011111111111111111111111111
10000000000000000000001
10000000000000000000001
10000000000000000000011
1111111111111111111111
