EA ./textures/eagle.xpm
S ./textures/sprite_1.xpm
R   700  300                              
F 0,100,255        

NO   ./textures/wall_1.xpm  
SO ./textures/wall_2.xpm
WE ./textures/wall_3.xpm
C 202, 20, 11
1111111111111111111111
10000000001
100000000111111111111
10000000000000000000111111111111111111111111111
1000000000000000000000000000000000000000000001
10000000000000000000000000000000000000000000001
10000002222220000000111111111111111111111111111
100E000022222000000001
100000002222200000001
10000000222220000000011
1000000000000000000001
1000000000000000000001
1000000000000000000001
1000000000000000000001
1000000000000000000001
1111111111111111111111