R    1024 768
F 255,100 , 11
NO ./pa
SO ./path_to_the_south_texture
WE        ./path_to_the_west_textur
EA ./ath_to_the_east_texture
S ./path_to_the_sprite_textur
C 225,20,111


1111111111111111111111
100000000000000000000111
100000000000000000000001
100000000000000000000001111111111111111111111111
100000000000000000000000000000000000000000000001
1000000000000000000000E0000000000000000000000001
100000000000000000000011111111111111111111111111
10000000000000000000001
10000000000000000000001
10000000000000000000011
1111111111111111111111
