R 1600 1200
NO ./textures/wall_1.xpm
SO ./textures/wall_2.xpm
WE ./textures/wall_3.xpm
EA ./textures/wall_4.xpm
S ./textures/sprite_1.xpm
F 184,113,39
C 51,198,227

    11
    1111111111111111111111111111111111111
1111100000000000000002222000011000001
1000000000000000E00002222000011111111
100000000000000000000222200000000001111111111111111111111
100111110000000000000000000001100000000000000000000000001
1001  110000000000000000000001100000111111110111111111111
1111  1100111111111100001111111101111      1011
      11001         100001111111011111111111011
      1101111111111100001      1000000000000001
      1100000000000000011      1111111111111111
      1111111111111110011
                   111111   1111111111111
                            1111111111111
