R  300 300
S  ./textures/pillar.xpm
EA ./textures/eagle.xpm
NO ./textures/wall_1.xpm
SO ./textures/wall_2.xpm
WE ./textures/wall_3.xpm
F  202,0, 33
C  202,0, 33
      
       1
11111110111111111
10000000000000001
10200000200000201
10000000000000001
10002000200020001
10000000000000001
10202020002020201
10000000000000001
10002000200200001
100000S0000000001
10200000200002001
10000000000000001
11111111111111111