R 848 480
F 184,113,39
C 51,198,227

11111111111111111111111111111
10000000001100000000000000001
10110000011100000000000010001
10010000000000000000000010001
10110000011100000000000010001
10000000001100000111011110001
11110111111111011100000010001
11110111111111011101010010001
11000000110101011100000010001
10000000000000001100000010001
10000000000000001101010010001
11000000110101000000000000001
11110111110101000000000000001
10000000001100000100000010001
10000000000000001010000101001
10000000001000010001010001001
10000000001101000000N00000001
10000000000100000001010000001
11111111111111111111111111111

1111111111
1200000001
1100000000111111111111
10000000001020100000111111111111111111111111111
10000000001000100000000000000000000000000000021
10000000000000000000000000000000000000000000001
1000E000000000000200111111111111111110111111111
1000000000000000000001              101
1000000002000000000011              101
1000000000000000000001111111111111111011111
10000000000000000000000022222222222222222221
10000000000000000000010022222222222222222221
10011011100000000000010022222222222222222221
10021002100000000000010022222222222222222221
10001000100000000000011111111111111111111111
11111111111111111111110
